111111111
100E00001
1P0001C01
10C000C01
111111111
