111111111
100E00001
1P0001001
100000C01
111111111
