1111111111
100E00001
1P00010E1
100E00001
111111111
