111111111
101E00001
1P1001C01
10C000C01
111111111
